15
15
XXXXXXXXXXXXXXX
X  X    XX    X
X X  XX    X XX
X X X  XXXXX  X
X     XX    X X
XXXX X   X X  X
X     XX X X XX
X XXXX X SXX  X
X X X    X  X X
X X   XXX  X  X
X  X X   X X XX
X    X XXX    X
X XXX  XEXXXX X
X     X       X
XXXXXXXXXXXXXXX